active = faol
already = allaqachon
argument = bahs/munozara
assignment = vazifa
believe in = ga ishonmoq
belong to = ga tegishli bo'lmoq
bump = urushtirmoq
cancer = saraton kasalligi
ceremony = marosim
cheek = yanoq
chest = ko'krak
chin = iyak/dahan
clap = qarsak chalmoq
congratulate = tabriklamoq
consist of = dan iborat bo'lmoq
cycling = velosiped haydamoq
depend on = ga bog'liq bo'lmoq
depressed = ruhiy tushkun holatda
diabetes = qandli diabet
diet = ovqatlanish
disease = kasallik/xastalik
dream of = haqida orzu qilmoq
easy = oson
elbow = tirsak
experiment = tajriba
fist = musht
fitness = yaxshi jismoniy holat
forehead = peshona
gentle = yengil
germs = mikrob/bakteriya
graduation = bitiruv
greet = salomlashmoq
greeting = salomlashish
handshake = qo'l berib ko'rishish
happen = sodir bo'lmoq
health = sog'liq
hug = quchoqlamoq
impression = taassurot
informal = norasmiy
junk food = sog'liqqa zararli ovqat
kiss = o'pmoq
lip = lab
medical = tibbiy
mental health = ruhiy sog'liq
natural = tabiiy
nod = bosh silkitmoq
painkiller = og'riq qoldiruvchi
peace = tinchlik
philosophy = falsafa
press = bosmoq
reserve = buyurtma qilmoq
respect = hurmat qilmoq
ridiculous = axmoqona
shake hands = qo'l berib ko'rishmoq
rude = qo'pol
shoulder = yelka
sleeve = yeng
smile = kulmoq/jilmaymoq
stick = chiqarmoq
succeed in = da muvofaqqiyat qozonmoq
thumb = bosh barmoq
tongue = til
touch = tegmoq
trend = urf/odat
virus = virus
weapon = qurol
work for = da ishlamoq/ga ishlamoq
weight-lifting = og'ir atletika