accommodation = turar joy/boshpana
advantages = afzalliklar
hayratlangan = amazed/surprised
annoyed = hafa
apply = topshirmoq/qo'llamoq
basic = oddiy
book in advance = oldindan buyurtma bermoq
book your flight = parvozni bron qilmoq
bored = zerikkan
bus pass = oylik avtobus chiptasi
code = kod
confusing = chalkash
convenient = qulay
currency = pul birligi
cycle lane = velosiped yo'li
diesel = dizel
efficient = samarali
embarrassing = uyatli/hijolatli
exciting = qiziqarli
fare = yo'l haqi
fascinated = maftun bo'lgan
fascinating = ajoyib/maftunkor
float = suzmoq/qalqimoq
foreign = xorijiy
frightening = qo'rqinchli
fuel = yonilg'i
greener = atrof muhitga havfsizroq
guidebook = qo'llanma
high-speed = yuqori tezlikka ega
hire = yo'llamoq
hostel = mehmonxona
in advance = oldindan
insurance = sug'urta
last-minute = ishiga puxta bo'lmagan
line = yo'nalish
luggage = yuk
main road = asosiy yo'l
petrol = benzin
planner = rejalashtiruvchi
pollution = ifloslash
predict = bashorat qilmoq
reality = haqiqat/voqelik
registration form = ro'yxatdan o'tish shakli
regular = muntazam
relaxed = xotirjam
relaxing = roxatbaxsh
reliable = ishonchli
remote = uzoq/olis
replace = almashtirmoq
self-catering = o'z-o'ziga taom pishiruvchi
souvenir = estalik
surprising = hayratlanarli
thermometer = termometr
tiring = toliqtiruvchi
truck = rels
traffic jam = harakat tirbandligi
worried = xavotirlangan
worrying = tashvishli