above = yuqorida
airport	= aeroport
armchair = kreslo
bank = bank
bathroom = hammom
bed = yotoq/krovat
bedroom	= yotoqxona
behind	= orqasida
between	= orasida
big	= katta
booking form = bron qilish anketasi
bookshop = kitob do'koni
building = bino
campsite = lager
capital	= poytaxt
carpet = gilam
cheap = arzon
chemist = apteka/aptekachi/kimyogar
cinema = kinoteart
clean = toza/ozoda
cooker = pishiriq pishirish pechi
dining room	= oshxona/ovqatlanish xonasi
dishwasher = idish yuvish mashinasi
easy = oson
expensive = qimmat
fantastic = fantastik/ajabtovur
flat = ko'p qavatli uy/kvartira
fridge = muzlatgich
furniture = mebel
garage = garaj
hairdresser's = sartaroshxona
hospital = kasalxona
housemate = uydosh
in front of	= ning to'grisida/ro'parasida
instructions = ko'rsatmalar
kitchen	= oshxona
laundrette = kir yuvish xizmati ko'rsatiladigan joy
lazy = dangasa/erinchoq
library	= kutubxona
light = yorug'lik/yorug'/yengil
living room	= uydagi mehmonxona
market	= bozor
messy = tartibsiz
mine = shaxta/ruda/kon
museum = muzey
next to	= yonida
old	= eski
on = ustida
opal = opal/qimmatbaho tosh
opposite = qarama-qarshi/qarshisida
organized = tashkil etilgan
palace = saroy
passport = pasport
post office	= pochta
railway station	= temir yo'l stansiyasi
scarf = sharf
shelf = javon/polka
studio flat	= bir xonali kvartira
swimming pool = suzish havzasi
table = stol
temple = ibodatxona
terrible = daxshatli
theater	= teatr
tidy = toza
toilet	= hojatxona
tour = sayohat
tourist	= turist
tourist information center = turistik axborot markazi
town = shahar
to travel = sayohat qilmoq
ugly = xunuk
under = ostida
underground	= yer osti
to visit = tashrif buyurmoq
washing machine	= kir yuvish mashinasi
window = oyna
go straight	= to'g'riga boring
turn left = chapga buriling
turn right = o'ngga buriling
along = birga
among = orasida
junction = chorraha