to bake = pishirmoq/non yopmoq
beef = mol go'shti
to boil = qaynatmoq
bowl = kosa
bread = non
castle = qasr
chicken = tovuq
to chop = kesmoq
cube = kub
delicious = mazali
food processor = blender/oziq-ovqat protsessori
fork = sanchqi/vilka
fruit = meva
fry = qovurmoq
frying pan = tova/skovorodka
honey = asal
ingredient = massaliq
jam = murabbo
knife = pichoq
lemon = limon
lemonade = limonad
main course = asosiy taom
microwave = mikroto'lqinli pech/mikrovalnovka
mix = aralashtirmoq
mushroom = qo'ziqorin
noodles = lag'mon
olive = zaytun
oven = pech/pechka
pasta = makaron
pear = nok
plate = tarelka
to prepare = tayyorlamoq
ready-made = tayyor/tayyorlangan
rice = guruch
to roast = qizartirib qovurmoq/qovurmoq
rooftop = mansarda/binoning tom qismi
salad = salat
saucepan = qozon
secret = sir
spoon = qoshiq
starter = birinchi taom
survey = so'rovnoma/tadqiqot
sweet = shirin/shirinlik
sweetcorn = shirin jo'xori/popkorn
takeaway food = olib ketiladigan ovqat/soboy ovqat
unhealthy = nosog'lom
view = ko'rinish
wonderful = ajoyib
yoghurt = yogurt
acidic = kislotali
bland = yumshoq
creamy = qaymoqli
fatty = yog'li
fruity = mevali
oily = zaynutli/yog'li
raw = xom
sharp = o'tkir/keskin/keskir
tender meat = yumshoq go'sht
tough = qattiq