American = amerikalik/amerikan
Arabic = arab tili/arabcha
artist = rassom
aunt = xola/amma
boss = xo'jayin/boshliq
British = Britaniya
brother = aka/uka
brother-in-law = kuyov/pochcha/qanyaka-qaynuka
business management = biznes boshqaruvi
car mechanic = avtomobil ustasi
child = bola
children = bolalar
Chinese = xitoylik
to communicate = muloqot qilish
country = mamlakat
cousin = jiyan/amakivachcha/xolavachcha/tog'avachcha/ammavachcha
daughter = qiz farzand
designer = dizayner
Emirati = Birlashgan Arab Amirligidan
family name = oilaviy familiya
father = ota
fluent = ravon gapiruvchi
French = fransuz/fransiyalik
genetic = genetika
granddaughter = qiz nabira
grandfather = bobo/buva
grandmother = buvi/momo
grandson = o'g'il nabira
Greek = yunon tili/yunoncha
Hungarian = venger/vengriyalik
husband = er
to introduce = tanishtirish
Italian = italyan tili/italyancha/italiyalik
Japanese = yapon tili/yapon millati
last name = familiya
Lebanese = livanlik
married = turmush qurgan/uylangan yoki erga tekkan
Mexican = meksikalik
mother = ona
nationality = millat
neighbour = qo'shni/hamsoya
nephew = o'g'il jiyan
niece = qiz jiyan
Nigerian = nigeriyalik
Pakistani = pokistonlik
Polish = polyak tili/polyak millati
Portuguese = portugal tili/portugal millati
restaurant = restoran
Russian = rus tili/rus millati
saxophone = saksafon
single = yolg'iz/yakka
sister = opa/singil
son = o'g'il farzand
Spanish = ispan tili/ispancha/ispaniyalik
stepfather = o'gay ota
supermarket = supermarket
Turkish = turk tili/turkcha
twin = egizak
typical = odatiy
uncle = amaki/tog'a
unemployed = ishsiz
Urdu = urdu tili
Vietnamese = vetnamlik
wife = xotin
mouse = sichqon
mice = sichqonlar
woman = ayol
women = ayollar
man = erkak
men = erkaklar
foot = oyoq
feet = oyoqlar
tooth = tish
teeth = tishlar
goose = g'oz
geese = g'ozlar
sheep = qo'y
deer = kiyik
criteria = mezon