annually = har yili
to award = mukofot bermoq/taqdirlamoq
awful =	o'ta yomon
to bark	= vovullamoq
brilliant = ajoyib/brilliant
to celebrate = nishonlamoq
charity = xayriya/ehson
coach = murabbiy/trener
common = umumiy
community = jamiyat
constantly = doimiy/doimiy tarzda
crucial = hal qiluvchi ahamiyatga ega
delighted = maftun qiluvchi/xursand/mamnun
dietician = dietolog
elderly = keksa/qari/yoshi katta
excellent = a'lo
to fail	= uddasidan chiqa olmaslik/imtihondan yiqilish
to focus = diqqatni jamlash/fokus qaratish
to help	= yordam berish
homeless = uysiz
huge = ulkan/bahaybat
to improve = yaxshilamoq/yuksaltirmoq
individual = individual
to look after = g'amxo'rlik qilmoq
lovely = yoqimli/sevimli
massive = katta
maximum = maksimal
member = a'zo
to organize = tashkil qilmoq/tashkil etmoq
to paint = bo'yamoq/chizmoq
to plant = o'simlik ekmoq/ekin ekmoq
player = o'yinchi/futbolchi
to repair = ta'mirlamoq
resident = rezident/yashovchi
scared = qo'rqib ketdi/qo'rqib ketgan
soil = tuproq
tax = soliq
to teach = o'rgatmoq/o'qitmoq
team = jamoa
tiny = tor/kichkina/jajji
worried	= xavotirda
laptop = noutbuk
personal computer = shaxsiy kompyuter
tablet = planshet
to surf the web	= internetda o'tirish
to shop online = onlayn xarid
smartphone = smartfon
vacuum cleaner = changyutgich
remote control = pult
to chat with friends = do'stlar bilan yozishish
access = kirish/dostup/huquq
to download	= yuklab olmoq
to hack	= buzmoq
stop pollution = ifloslanishni to'xtatish
power station = elektr stantsiyasi
device = qurilma
graduate = bitiruvchi
resource = manba
to provide = yetkazib bermoq/ta'minlamoq
to connect = bog'lamoq
resolution = qaror/hukm/rezolutsiya
promise = va'da bermoq/so'z bermoq