baker's = nonvoyxona
boring = zerikarli
butcher's = qassobxona
button = tugma
careful = ehtiyotkor
carefully = ehtiyotkorlik bilan
cash = naqd pul
changing room = kiyim almashtirish xonasi/kiyinish xonasi
clear = aniq
clearly = aniqlik bilan/aniq tarzda
coat = palto
correct = to'g'ri
correctly = to'g'ri tarzda/to'g'rilik bilan
dangerously = xavfli tarzda
designer = dizayner
shoes = oyoq kiyimi/oyoq kiyim
disappointed = hafsalasi pir bo'lgan
dress = ayollar ko'ylagi/ko'ylak
gloves = qo'lqoplar
good = yaxshi
great = ajoyib
hat = shlyapa/shlapa
heavy = og'ir
hoodie = hudi/xudi/qaytarma qalpoqli kiyim
information = ma'lumot/axborot
jacket = kurtka
jeans = jinsi shim
jewellery = zargarlik buyumlari
meat = go'sht
newsagent's = gazeta do'konlari/kioska/kiosk
online = onlayn
poor = kambag'al
postcard = pochta kartasi
quiet = tinch/sokin
quietly = sokinlik bilan/sokin tarzda/tinch tarzda
rainwater = yomg'ir suvi
reading = o'qish
glasses = ko'zoynaklar
receipt = kvitansiya
to recommend = tavsiya etmoq/tavsiya qilmoq
to relax = dam olmoq/rohatlanmoq
to return = qaytmoq/qaytarmoq
sales = sotish/savdo
serious = jiddiy
shopping center = savdo markazi
shorts = shortiklar/qisqa videolar
simple = oddiy
skirt = yupka
slow = sekin
slowly = sekinlik bilan/sekin tarzda
socks = paypoqlar
to spend = sarflamoq
strong = kuchli
suit = kostyum
tie = galstuk
trainers = krossovkalar/murabbiylar
trousers = shim
T-shirt = futbolka
umbrella = soyabon
value = qiymat
vending machine = savdo avtomati
virtual = virtual
wedding = to'y
well = yaxshi
worth = arziydigan qiymat/narxiga arziydigan qiymat
a cheque = chek
credit card = kredit karta
cash = naqd pul
trolley = aravacha
wallet = hamyon
purse = hamyon
scale = shkala
cashier = kassir
customer = mijoz
barcodes = shtrix kodlar