acrobat = akrobat
action film = jangari film
album = albom
animation = animatsiya
eat = yemoq
autistic = autistik
band = musiqiy guruh
black and white	= qora va oq
blind = ko'r/ko'zi ojiz
buy = sotib olmoq/xarid qilmoq
break = sinmoq/sindirmoq
circus = sirk
to clap = qarsak chalmoq
collection = kolleksiya/yig'ilgan narsalar to'plami
comedy = komediya
concert = konsert
deaf = kar/qulog'i eshitmaydigan
drama = drama
drink = ichmoq
drum = baraban
experience = tajriba
favourite = sevimli
future = kelajak
helicopter = vertolyot
horror film = daxshatli film/ujas film
illness = kasallik
independence = mustaqillik
instrument = asbob/instrument
lesson = dars
love story = sevgi hikoyasi
music festival = musiqa festivali
musical = musiqiy sahna ko'rinishi
opera = opera
painting lesson = rasm chizish darsi/rasm darsi
to play = o'ynamoq/biror musiqa asbobini chalmoq
to prefer = afzal ko'rmoq
prize = mukofot/sovrin
romantic film = romantik film
scary = qo'rqinchli
science-fiction film = ilmiy-fantastik film
stage = bosqich
star = yulduz
surprise = ajablantirmoq
belief = e'tiqod/ishonch
design = dizayn
dialect = dialekt/sheva
ethic = axloq
ethical = axloqiy
heritage = meros
knowledge = bilim
norms = normalar
tradition = an'ana
generation = avlod
art	= san'at/rassomchilik
thriller = triller
fantasy = fantaziya
fiction = fantastika
adventure = sarguzasht
period drama = tarixiy ma'lum bir vaqt dramasi
romantic comedy = romantik komediya
historical film	= tarixiy film