address = manzil
administrator = administrator
again = yana
airline = aviakompaniya
answer = javob
author = muallif
baker = nonvoy
beginner = boshlang'ich/boshlovchi
builder	= quruvchi
bus driver = avtobus haydovchisi
businessman	= tadbirkor/biznesmen
businesswoman = tadbirkor ayol/biznesmen ayol
calm = sokin/tinch
chef = oshpaz
cleaner = tozalovchi
clever = aqlli
colleague = hamkasb
company = kompaniya
dancer = raqqosa/raqqos
dentist	= stomatolog/tish shifokori
driver = haydovchi
to earn	= pul ishlab topmoq
farmer = dehqon/fermer
to fix = tuzatmoq/tuzatish
forest = o'rmon
to forget = unutmoq/esdan chiqarmoq
hairdresser	= sartarosh
important = muhim
inside = ichida/ichkarida
internet = internet
journalist = jurnalist
later = keyinroq
lonely = yolg'iz tarzda/yolg'izlik bilan/yolg'izlikda
lookout	= kuzatuvchi
lucky = omadli
magazine = jurnal
manager	= menejer
money = pul
mp3 player = mp3 pleyer/mp3 player/mp3 ijrochi
musician = musiqachi
nurse = hamshira
office worker = ofis xodimi/ofis ishchisi
painter	= bo'yoqchi/rassom
part time = to'liq bo'lmagan ish vaqti
photographer = fotograf/suratkash
piano = pianino
pilot = uchuvchi
work place = ish joyi
police officer = politsiyachi/politsiya ofitseri/militsiya xodimi
retired = nafaqaga chiqqan
salary = maosh/oylik ish haqi/ish haqi/oylik
silent = jim
singer = qo'shiqchi
student	= talaba
teacher	= o'qituvchi
ticket = chipta/bilet
tower = minora
uniform	= forma
unusual	= noodatiy
well-paid = yaxshi maoshli/yaxshi to'lanadigan
winner = g'olib
work freelance = mustaqil ishlash
work long hours	= uzoq vaqt ishlash
writer = yozuvchi
architect = arxitektor
travel agent = sayohat agenti
receptionist = qabulxona ishchisi/qabulxonachi
sales assistant	= yordamchi sotuvchi/yordamchi savdogar/sotuvchi
sports coach = sport murabbiyi
tour guide = ekskursiya yo'riqchisi/gid