to agree = rozi bo'lmoq
alone = yolg'iz/yakka
to ask = so'ramoq
astronaut = astronavt
beach = plyaj/dengiz qirg'og'i
body clock = tana soati
break = tanaffus/sinmoq/sindirmoq
breakfast = nonushta
canteen = oshxona
cereal = boshoqli ekin
class = sinf
dangerous = xavfli
dirty = iflos/kir
discount = chegirma
expert = mutaxassis/ekspert
eyesight = ko'rish qobiliyati
to feel well = yaxshi his etmoq/yaxshi his qilmoq
free = ozod/erkin/tekin
free time = bo'sh vaqt
fresh air = toza havo
to get up = turmoq
to go = bormoq
to go clubbing = klubga bormoq
to have dinner = kechki ovqatni yemoq/kechki ovqat yemoq
to have lunch = tushlik qilmoq
hungry = och qolgan/qorni och
idea = g'oya/fikr
journey = sayohat
lab = laboratoriya
late = kech/kechikish/kechikmoq
to listen = tinglamoq
meeting = uchrashuv
noisy = shovqinli
outside	= tashqarida
to pay	= to'lamoq/to'lash
penguin	= pingvin
perfect	= mukammal
physics	= fizika
plan = reja
professor = professor
public transport = jamoat transporti
to read = o'qimoq
to reply = javob bermoq
to rise = ko'tarilmoq/ko'tarilish
sandwich = sendvich
scientific = ilmiy
scientist = olim
seal = tulen/muhr
shop = do'kon
shower = dush
sickness = kasallik
soup = sho'rva
space = koinot/bo'shliq
spacesuit = skafandr
to start = boshlamoq
to stop = to'xtamoq
student card = talaba kartasi
to think about something = nimadir haqida o'ylamoq
tired = charchagan
title = sarlavha/nom/unvon
toast = qovurilgan non/qizartirilgan non
trainer	= ish o'rganuvchi/murabbiy
volcano = vulqon
to wait	= kutmoq
to wake up = uyg'onmoq
wall = devor
to watch a film	= film tomosha qilmoq
to watch TV	= televizor ko'rmoq/TV ko'rish
to work	= ishlamoq
zoology	= zoologiya
to do the laundry = kir yuvmoq
to hang the clothes	= kiyimlarni ilib qo'ymoq/kiyimlarni osib qo'ymoq
to iron the clothes	= kiyimlarni dazmollamoq
to make the bed	= to'shakni tiklamoq
to go to bed = uxlagani yotmoq/uxlashga yotmoq
to brush the teeth = tishlarni tozalamoq/tishlarni yuvmoq
to drive to work = ishga mashina haydab bormoq
to get home	= uyga bormoq/uyga qaytmoq
to take a bath = dush qabul qilmoq/hammom qabul qilmoq