air-conditioned = konditsionerli/konditsioneri bor
amazing = ajoyib
apartment = kvartira
art gallery = san'at galereyasi
bike = velosiped
bus	= avtobus
car	= mashina/avtomobil
city break = shahardan tashqarida dam olmoq
colourful = rangli
countryside = qishloq joy
culture	= madaniyat
dinner = kechki ovqat
employee = xodim/ishchi
environment	= atrof muhit
to get = olmoq
to get around = aylanib yurmoq
group = guruh
guest house	= mehmonxona
guide = gid
helmet = kaska/shlem
to hold	= tutmoq
to lie = yotmoq
map	= xarita
to miss	= o'tkazib yubormoq/sog'inmoq
mountain = tog'
passenger = yo'lovchi
platform = platforma
queue = navbat
railway	= temir yo'l
rainforest = yomg'irli o'rmon
to rent	= ijaraga olmoq/ijaraga olish
ruins = xarobalar
seat belt = xavfsizlik kamari
sightseeing	= diqqatga sazovor joylar/diqqatga sazovor joy
single = bir tomonlama bilet/bir tomonlama chipta/yolg'iz/turmush qurmagan
street life	= ko'cha hayoti
sunrise	= quyosh chiqishi
taxi = taksi
text message = matnli xabar
tip	= choy chaqa/maslahat
tradition = an'ana
train = poyezd
to trek	= mashaqqatli sayohat/sayohat/piyoda sayohat
destination	= manzil
excursion = ekskursiya
to go camping = yurishga chiqmoq/toqqa yurishga chiqmoq/yurishga chiqish/toqqa yurishga chiqish
to go sightseeing = diqqatga sazovor joylarni tomosha qilgani bormoq/diqqatga sazovor joylarni ko'rishga bormoq/diqqatga sazovor joylarni tomosha qilgani borish/diqqatga sazovor joylarni ko'rishga borish
hostel = yotoqxona
motel = mehmonxona
journey	= sayohat
luggage	= bagaj
package holiday	= rejalashtirilgan tur sayohat/rejalashtirilgan tur