accent = aksent/urg'u
to blow = puflamoq/esmoq
busy = band
camp = lager
climate = iqlim
close = yaqin
cloudy = bulutli
coast = qirg'oq/sohil
compass = kompas
crazy = aqldan ozgan
deep = chuqur
desert = cho'l
dry = quruq
east = sharq
equipment = uskunalar/anjomlar
first-aid kit = birinchi yordam to'plami
foggy = tumanli
freeze = muzli/muzlash
freezing = muzlash
hard worker = mehnatkash
high = yuqori/baland
hot = issiq
icy = muzli
island = orol
jungle = jungli/jungli o'rmoni/o'rmon
lake = ko'l
large = keng/katta
low = past
mild = o'rtacha havo/issiq ham emas sovuq ham emas
north = shimol
oasis = oazis/sahro
rain = yomg'ir
rainy = yomg'irli
river = daryo
sandy = qumli
score = baho/ochko
to shine = porlamoq/charaqlamoq/nur sochmoq
sleeper = uyquchi
snow = qor
snowy = qorli
south = janub
storm = bo'ron
stove = pechka
sunny = quyoshli
survival = omon qolish
to survive = omon qolmoq/tirik qolmoq/omon qolish/tirik qolish
temperature = harorat
tent = chodir/palatka
thunder = momaqaldiroq
torch = fonar/mash'al/mash'ala
traffic = transport vositalari harakati/tirbandlik/probka
tropical = tropik
warm = iliq
waterfall = sharshara
weather = ob-havo
weather forecast = ob-havo ma'lumoti
west = g'arb/g'arbiy
wet = nam/ho'l
windy = shamolli
worker = ishchi
showers = shivalab yog'adigan yomg'ir
shine = yarqiramoq/charaqlamoq/nur sochmoq
overcast = bulutli havo
it's snowing = qor yog'yapti
it's raining = yomg'ir yog'yapti
it's windy = shamol esyapti
cool = salqin
cold = sovuq
warm = iliq
hot = issiq