app = ilova/dastur
to ban = taqiqlamoq/taqiqlash
basketball = basketbol
to borrow = qarzga olmoq/qarzga olish/olib turish
to bring = olib kelmoq/olib kelish
bucket = chelak
to come	= kelmoq
to cycle = velosiped haydamoq/velosiped haydash
to do = qilmoq/bajarmoq
to drink = ichmoq/ichish
to eat = yemoq/yeyish
fit	= ozg'in/sog'lom jismoniy holat
football = futbol
gadget = gadjet
to go fishing = baliq ovlashga bormoq
gym	= sportzal
habit = odat
healthy	= sog'lom
hero = qahramon
to jog = yugurmoq
judo = dzyudo/dzudo
to learn = o'rganmoq
to lend	= qarz bermoq
lift = lift
lightning = chaqmoq
local = mahalliy
to lose	= yo'qotmoq
marathon = marafon
mayor = mer/hokim
opinion	= fikr
paper clip	= qog'oz uchun qisqich
physical = jismoniy
progress = taraqqiyot
to reduce = kamaytirmoq/kamaytirish
research = tadqiqot
to ride	= minmoq/minish
routine	= muntazam qilinadigan  ishlar
to run = yugurmoq/yugurish
to sleep = uxlamoq/uxlash
studio = studiya
subtitle = subtitr
to swim = suzmoq/suzish
to take	= olmoq/olish
tennis = tennis
thunderstorm = momaqaldiroq
violent = zo'ravon
to walk = yurmoq/yurish
excellent = a'lo
to decline = yomonlashmoq
fragile	= nozik
ill	= kasal
poor = kambag'al
to look after = g'amxo'rlik qilmoq/avaylamoq/asramoq
to maintain	= ushlab turmoq
to improve = yaxshilamoq
damage = zarar
risk = tavakkal/xavf