a bit = ozgina
believe	= ishonmoq
bobsleigh = bobsley/chang'i uchmoq/chang'i uchish
to call	= chaqirmoq
change = o'zgartirmoq/o'zgartirish
classroom = sinf xonasi
to collect = yig'moq/yig'ish
to copy	= nusxa ko'chirmoq/nusxa ko'chirish
to decide = qaror qabul qilmoq
fashion designer = moda dizayneri
to finish = tugatmoq/tugatish
founder	= asoschi
ice skater = konkida uchuvchi/konkichi
interesting	= qiziqarli/qiziq
label = teg
like = kabi
to live	= yashamoq/yashash
to look	= qaramoq/qarash
to love	= sevmoq/sevish
modern art = zamonaviy san'at
to move	= harakatlanmoq/harakatlanish/ko'chish
naughty	= yaramas
notice = xabarnoma
open = ochiq
to play	= o'ynamoq/chalmoq
popular	= mashhur/taniqli
to post	= post yubormoq/post yuborish/post qilish
to prepare = tayyorlamoq/tayyorlash
product	= mahsulot
quite = birozgina/biroz/yaxshigina
really = haqiqatdan ham/haqiqatdan
to receive = qabul qilmoq/qabul qilish
to return = qaytmoq/qaytarmoq/qaytish/qaytarish
sculpture = haykaltaroshlik/haykal
to shout at	= baqirmoq/baqirish
to start = boshlamoq/boshlash
to study = o'rganmoq/o'qimoq/o'rganish/o'qish
successful = mufavvaqiyatli
to talk = gaplashmoq/gaplashish/gapirish
to thank = minnatdorchilik bildirmoq/rahmat aytmoq/rahmat aytish/minnatdorchilik bildirish
use	= foydalanmoq/foydalanish
very = juda
want = xohlamoq/istamoq/xohlash/istash
watch = tomosha qilmoq/tomosha qilish
extremely = nihoyatda
terribly = dahshatli tarzda
horribly = dahshatli tarzda/qo'rqinchli tarzda
spectacularly = ajoyib tarzda
wonderfully	= ajoyib tarzda
insanely = aqldan ozgan holda
especially = ayniqsa
uncommonly = kamdan-kam hollarda
unusually = noodatiy tarzda
particularly = ayniqsa
remarkably = ajoyib
fairly = odilona
pretty = go'zal
not especially = ayniqsa emas