achievement = yutuq
angrily = g'azab bilan
angry = jahldor
anxious = havotirli
avoid = chetlab o'tmoq
backwards = orqaga/chalqancha
balloon = havo shari
behaviour = xulq
bother = bezovta qilmoq
calmly = bezovta qilmoq
capsule = kapsula
climb = oshib tushmoq/ko'tarilmoq
confused = chalkashgan/boshi qotgan
cook = oshpaz
dive = sho'ng'imoq
drop = tushirib yubormoq
easily = osonlik bilan
eater = horanda
embarrassed = xijolat bo'lgan
excited = hayajonlangan/xursand
exhousted = toliqqan
eye contact = ko'z bilan aloqa
fall = yiqilmoq/tushibketmoq
fluently = ravon
frightened = qo'rqqan/sarosimada
guilty = ayibdor
headphones = quloqchin
in a good mood = yaxshi kayfiyatda
intercom = aloqa vositasi
into = ichiga
jump = sakramoq
land = qo'nmoq
lift = ko'tarmoq/lift
loudly = baland ovozda
nervous = asabiy
nicely = muloyim
nightmare = qo'rqinchli tush
out of = ichidan
over = uzra/ustidan
parachute = parashutdan sakramoq
pleased = mamnun
politely = xushmuomilalik bilan
pull out = sug'urib olmoq
quickly = tezda
reader = kitobxon
rescue team = qutqaruv guruhi
round and round = aylanma harakat
runner = yuguruvchi
skydiving = parashut bilan sakrash
smartly = klassik uslubda
snowboarding = snovboard uchish
stranger = notanish/begona
straw = naycha
stressed = havotirlangan
take off = ko'tarilmoq
through = orqali/orasidan
towards = tomonga
traffic lights = svetofor
traveller = sayohatchi
typist = mashinist
video camera = video kamera
walker = piyoda/yo'lovchi