abroad = chet elda/chet elga
article = maqola
attachment = havola qilinadigan fayl
benefit = foyda
bunch = tutam/buket
carry on = davom etmoq
continent = qit'a
coral reef = marjon qoyalar
crash = halokat
cure = davo
election = saylov
erupt = otilmoq
expensive = qimmat
extreme = haddan tashqari
financial = moliyaviy
find out = bilib olmoq
flock = to'da
flood = suv toshqini
forest fire = o'rmon yong'ini
give up = tashlamoq
global = ommaviy/butunjahon
global warming = ommaviy harorat ko'tarilishi
grow up = katta bo'lmoq/ulg'aymoq
home-made = uy sharoitida tayyorlangan
hunger = ochlik
hurricane = to'fon
intelligent = aqlli
invention = ixtiro
issue = muammo
man-made = inson yaratgan
milestone = muhim bosqich
natural disaster = tabiiy ofat
powerful = kuchli/qudratli
reach = yetib bormoq
put down = qo'ymoq
put on = yig'moq/to'plamoq
report = xabar bermoq
robbery = o'g'irlik
sculptor = haykaltarosh
secure = xavfsizlik
set up = tashkil qilmoq
spread = tarqalmoq
steal = o'g'irlamoq
strike = ish tashlash
telegraph = telegraf
up to date = so'nggi/oxirgi
weekly = haftalik
wire = sim