achieve = erishmoq
after-school = darsdan tashqarida
art = san'at
atmosphere = muhit
blossom = gullash
communication skills = muloqot ko'nikmalari
connection = aloqa
course = kurs
creatively = ijodkorona
decision = qaror
degree = daraja
diploma = diplom
economics = iqtisodiyot fani
education = ta'lim
emotion = hissiyot
entrance exam = kirish imtihoni
explain = tushuntirmoq
fields = joylar
fully-qualified = yuqori malakali
grade = baho
history = tarix
imagination = tasavvur
ironing = dazmollash
IT = axborot texnologiyalari
languages = tillar
learning skills = o'rganish qobiliyatlari
literature = adabiyot
map reading = xaritani tushunish
master's degree = magistirlik darajasi
maths = matematika
mistake = xato
myth = afsona
next of kin = yaqin qarindosh
organ = tana a'zosi
organize = tashkil etmoq
PE = jismoniy tarbiya
photocopy = fotonusxa
practical skills = amaliy ko'nikmalar
private school = xususiy maktab
probably = balki
promotion = rag'batlantirish/lavozimini ko'tarish
psychology = ruxshunoslik
qualification = malaka
remember = eslamoq
science = ilm-fan
search engine = qidiruv tizimi
signal = signal
solve = hal qilmoq
spelling = imlo
state school = davlat maktabi
strict = qattiq qo'l
study = o'rganish
success = muvaffaqiyat
system = tizim
take care of = g'amxo'rlik qilmoq
tell jokes = hazil aytmoq
train = shug'ullanmoq
terrible = no'noq
understand = tushunmoq