alcoholic drink = spirtli ichimlik
apple juice = olma sharbati
bake = duxovkada pishirmoq
best before = gacha iste'mol qilish tavsiya qilinishi
boiled = qaynatilgan
bottle = butilka
box = quti
can = temir idish
cardboard = qalin qog'oz
carton = karton quti
charge = to'lov olmoq/to'lov talab qilmoq
chocolate = shokolad
consumer = iste'molchi
curry = qayla
dessert = shirinlik
different = turli xil
dish = ovqat
doggy bag = ovqat qoldiqlari uchun paket
figure = raqam/qomat
frozen = muzlatilgan
fry = qovurmoq
funny = kulguli
herb = giyoh
honey = asal
jar = banka
kind of = tur/xil
lamb = barra qo'zichoq go'shti
leave = qoldirmoq
left = chap
mark = belgi/baho
olives = zaytun
packet = pachka/paket
plain = oddiy
preserve = saqlamoq
pretty = chiroyli/ancha
raspberry = malina
raw = hom
sauce = sous
savoury = o'tkir ta'mli
serve = taomni tortmoq
several = bir nechta
shocking = hayratga soluvchi
snack = yengil taom
sour = nordon
sparkling water = gazli suv
spice = ziravorlar
spicy/bitter = achchiq
spinach = ismaloq
stew = tushenka/dimlama
strawberry = qulupnay
taste/flavour = ta'm/maza
taste buds = ta'm sezuvchi organ
texture = tuzilish/tarkip
thick = quyuq
tin = konserva banka
tobacco = tamaki
tomato = pamidor
toothpaste = tish pastasi
transportation = transport
use by = gacha yaroqli
wasteful = tejamaydigan