architect = me'mor
block = to'smoq
cafe = kafe
candle = sham/shag'am
CCTV camera = video kuzatuv kamerasi
cloth = mato
chest of drawers = tortmali javon
collect = yig'moq
crowded = gavjum
destroy = buzmoq/vayron qilmoq
dull = zerikarli
duvet = parko'rpa
dustpan and brush = xokandoz va cho'tka
fast lane = yo'lning yuqori tezlikta harakatlanish qismi
fine = jarimaga tortmoq
flower stall = gul rastasi
house swap = uy almashtirish
household possessions = uy ro'zg'or buyumlari
house-sit = uyga qarab turmoq
industry = sanoat
lively = jonli/jo'shqin
location = manzil
market place = bozor
maze = labirant
microwave over = mikro to'lqinli pech
mirror = tosh oyna
narrow = tor
navigation = boshqaruv
on business = ish yuzasidan
on holiday = ta'tilda
on public transport = jamoat transportida
on the internet = internetda
on the way = yo'lda
on time = o'z vaqtida
on TV = televizorda
pan = tova
parking space = to'xtash joyi
pavement artist = ko'cha rassomi
pedestrian area = piyodalar hududi
play area = o'yingoh/o'yin maydoni
project = loyiha
publisher = nashriyotchi
rage = g'azab
recycle = qayta ishlash
robot = robot
rubbish = chiqit
rug = gilamcha
safe = xavfsiz
satellite dish = sun'iy yo'ldosh antenasi
sheet = choyshab
shop display = do'kon ekrani
shopper = xaridor
solution = yechim
souvenir seller = suviner sotuvchisi
stall = do'koncha
statue = haykal
strange = g'alati
street cleaner = ko'cha tozalovchi
street performer = ko'cha ijrochilari
student accommodation = talabalar turar joyi
tap = jo'mrak
towel = sochiq
tower block = imorat
truck = yuk mashinasi
wardrobe = shkaf