about = taxminan
arrive = yetib kelmoq
attack = hujum qilmoq
become = bo'lmoq
blog = blog yozmoq
boxer = bokschi
buy = xarid qilmoq/sotib olmoq
challenge = qiyinchilik/mashaqqat
change career = kaspni o'zgartirmoq
choose = tanlamoq
concert hall = konsert zali
conductor = dirijyor
deal with = bilan ishlash
do online banking = bank opiratsiyalarini online bajarmoq
download = yuklab olmoq
engaged = unashtirilgan
get married = turmush qurmoq
go online = internetdan foydalanmoq
have a baby/children = farzand ko'rmoq
in your late twenties = 25 yosh bilan 29 yosh orasida
in your sixties = oltmish yoshlarda
learn to swim = suzishni o'rganmoq
leave home/school = uyni tarketmoq/maktabni bitirmoq
live with = bilan yashamoq
log on/out = tizimga kirish chiqish
mid = o'rtasida
middle-adge = o'rta yoshli
moment = lahza
move house or flat = uy yoki kvartirani almashtirmoq
obtain = erishmoq/olmoq
pass your exam = imtihondan o'tmoq
preform = ijro etmoq
pianist = pianinachi
present = sovg'a
read or listen to the news = yangiliklarni o'qish yoki tinglash
receive = qabul qilmoq
retire = nafaqaga chiqmoq
repetitive strain injury = surunkali pay cho'zilishi
review = sharh
seafront = dengiz bo'yi
share = bolishmoq
shop online = online harid qilmoq
social media = ijtimoiy tarmoq
take up = boshlamoq
talk = suhbat
teenager = o'spirin
travel = sayohat qilmoq
tweet = tviterda izzoh qoldirmoq
up date = yangilamoq
use = harakat
vase = guldon
vegetarian cookbook = vegetarianlar uchun pazzandalik kitobi
