accountant = buxgalter/hisobchi
administration = ma'muriyat
advertising campaign = reklama kompaniyasi
arm wrestle = kuch sinashish
building site = qurilish maydoni
business = ish/biznes
candidate = nomzod
mijoz = client/customer
construction = qurilish
corporate = korporativ/umumiy
court = sud
day-to-day = kundalik
engineering = muhandislik
enquiry = so'rov/rasmiy talab
entertain = ko'ngil ochmoq/mehmon qilmoq
health care = sog'liqni saqlash
in a hurry = shoshilib
in a mess = tartibsizlikda
in charge of = mas'ul/javobgar
in detail = batafsil
in the middle = o'rtasida
in trouble = ko'ngilsizlik
inventor = ixtirochi
judge = sudya/hakam
laboratory = labaratoriya
law = qonun
light bulb = lampochka
medical research = tibbiy tadqiqotlar
negative = salbiy
neutral = betaraf/netral
nurse = hamshira
open-plan = ochiq
paperwork = hujjat ishlari
personal assistant = shaxsiy yordamchi
politics = siyosat
positive = ijobiy
presentation = taqdimot
productivity = unimdor/hosildor
profession = kasb/hunar
real-life = hayotiy/haqiqiy
recruit = yollamoq
report = hisobot
software developer = dasturchi
staff = hodimlar
study = o'rganmoq/o'qimoq
zone = hudud

